__s___s___s___s__
=   = = =   =   =
=   = = b_s_b_s_b
b_s_b = =   = =  
= = b_n_b_s_b =  
= =     = = = =  
b_n___s_b = = =  
=   =   = = b_n__
=   =   = = =   =
b_s_b_s_b_n_b_s_b